+--+--+--+--+--+--+--+--+--+--+--+--+--+
                  |        |  |  |  |  |
+--+--+  +--+--+  +  +--+  +  +  +  +  +
|     |  |  |     |  |     |  |  |  |  |
+  +  +  +  +  +--+--+  +--+  +  +  +  +
|  |  |  |  |        |     |  |  |  |  |
+  +--+  +  +--+--+  +  +  +  +  +  +  +
|           |     |     |     |  |  |  |
+--+--+  +--+  +  +--+--+--+  +  +  +  +
|     |     |  |  |        |  |  |  |  |
+  +  +  +  +  +  +  +--+  +  +  +  +  +
|  |     |  |  |     |     |  |  |  |  |
+  +--+--+  +  +--+--+  +--+  +  +  +  +
|        |     |  |     |     |  |  |  |
+--+--+  +--+--+  +  +--+--+--+--+--+--+
|           |  |     |        |  |  |  |
+  +--+--+  +  +--+--+  +--+  +  +  +  +
|        |     |     |  |     |  |  |  |
+--+--+  +  +--+  +  +  +  +--+--+--+--+
|        |        |     |               
+--+--+--+--+--+--+--+--+--+--+  +  +  +
|        |        |     |               
+--+--+--+--+--+--+--+--+--+--+--+--+--+
